! # = Tile Legend 
! t = TileBlock
ttttttttttttttttt
t0000000t0000000t
t0tt0tt0t0tt0tt0t
t000000000000000t
t0t0t0ttttt0t0t0t
t000t000t000t000t
ttt0ttt0t0ttt0ttt
t0t0t0000000t0t0t
ttt0t0t000t0t0ttt
t00000t000t00000t
ttt0t0ttttt0t0ttt
t0t0t0000000t0t0t
ttt0t0ttttt0t0ttt
t0000000t0000000t
t0tt0tt0t0tt0tt0t
t00t000000000t00t
tt0t0t0ttt0t0t0tt
t0000t00t00t0000t
t0ttttt0t0ttttt0t
t000000000000000t
ttttttttttttttttt