! # = Tile Legend 
! t = TileBlock
tttttttttt
0000000000
0000000000
tt000000tt
0t000000t0
tt000000tt
0000000000
0000tt0000
0000tt0000
0000000000
tt000000tt
0t000000t0
tt000000tt
0000000000
0000000000
tttttttttt